░░░░░░░░░░░░░░
░░░░░░░░░░░K░░
←←←←←←←←←←←←←←
			 ↑
█→→↓ →→→→↓   ↑
   ╠→╣   ╠→→→↑
█→→↑ →↓ →↑    
      ╠→╣     
█→→→→→↑ ↓→→→→↓
◄◄◄◄◄◄◄◄◄◄◄←←←