░░░░░░░░░░░░░░
←←←←←←←←←←←K←←
             ↑
█→→↓ →→→→↓   ↑
   ╠→╣   ╠→→→↑
█→→↑ →↓ →↑    
      ╠→╣     
█→→→→→↑ →→→→→↓
◄◄◄◄◄◄◄◄◄◄◄←←←