 ░░░░░░░░░░░░░░x
x←←←←←←←←←←←K←← 
              ↑ 
 █→→↓ →→→→↓   ↑ 
    ╠→╣   ╠→→→↑ 
 █→→↑ →↓ →↑     
       ╠→╣      
 █→→→→→↑ →→→→→↓ 
 ◄◄◄◄◄◄◄◄◄◄◄←←← 